{
    "lv0":
    {
        "ascii": [
            "BBBBBBBBBBBBB",
            "B-----------W",
            "B--S-----S--W",
            "B-----P-----W",
            "B-----------W",
            "WWWWWWWWWWWWW"
        ]
    }
}