{
    "lv0":
    {
        "ascii": [
            "WWWWWWWWWWWWW",
            "W-----------W",
            "W--S-----S--W",
            "W-----P-----W",
            "W-----------W",
            "WWWWWWWWWWWWW"
        ]
    }
}